31	Fruits
Apple	リンゴ
Banana	バナナ
cherry	サクランボ
fruit	果物
grape	ブドウ
lemon	レモン
melon	メロン
orange	オレンジ
peach	桃
pear	洋梨
acerola	アセロラ
apricot	アンズ
avocado	アボカド
berry	ベリー
blueberry	ブルーベリー
coconut	ココナツ
fig	イチジク
grapefruit	グレープフルーツ
kiwifruit	キウイフルーツ
lime	ライム
lychee	ライチ
mango	マンゴー
olive	オリーブ
papaya	パパイヤ
persimmon	柿
pineapple	パイナップル
plum	セイヨウスモモ
raspberry	キイチゴ
strawberry	イチゴ
watermelon	すいか